1 1 1 1 1 1 1 1 1 1 1 1 1 1
1 1 1 1 1 1 1 1 1 1 1 1 1 1
1 1 0 0 0 0 0 0 0 0 0 0 1 1
1 1 0 0 0 0 0 0 0 0 0 0 1 1
1 1 0 0 0 0 0 0 0 0 0 0 1 1
1 1 0 0 0 0 0 0 0 0 0 0 1 1
1 3 0 0 0 0 0 0 0 0 0 0 3 1
1 3 0 0 0 0 0 0 0 0 0 0 3 1
1 3 0 0 0 0 0 0 0 0 0 0 3 1
1 3 0 0 0 0 0 0 0 0 0 0 3 1
1 1 0 0 0 0 0 0 0 0 0 0 1 1
1 1 8 0 0 0 0 0 0 0 0 8 1 1
1 1 1 1 1 1 1 1 1 1 1 1 1 1
1 1 1 1 1 1 1 1 1 1 1 1 1 1